000000000000000
000000000000000
000000000000000
000000000000000
000000000000000
000100000000000
000110000000000
000101000000000
000100100000000
000100010001000
000100001001000
000000000101000
000000000011000
000000000101000
000000001001000
000111010000000
000000100100000
000001000000000
000000000000010
000001000000000